S#######
    ####
### ####
#      #
### ####
#      #
# ######
#      #
# # # ##
# # #  #
# # ## #
# #  # #
###  ###
#      #
#      #
#      #
# #### #
#      #
###### #
E      #
########
