########S########
#        #      #
# # # ######### #
# # #           #
#   ##########  #
## ## # #       #
#       #########
####### #       E
#         ## ####
###########      
#################
